君=きみ
影=かげ
星=ほし
朝=あさ
溶=と
消=き
行=い
先=さき
失=な
想=おも
溢=あふ
强=つよ
弱=よわ
心=こころ
向=む
合=あ
明日=あした
来=き
怖=こわ
二人=ふたり
歩=ある
时=とき
信=しん
欲=ほ
真実=しんじつ
嘘=うそ
夜=よる
明=あ
来=く
星空=ほしぞら
辉=かがや
知=し
梦见=ゆめみ
一人=ひとり
顷=ごろ
目=め
见=み
何=なに
映=うつ
时=とき
谁=だれ
消=け
孤独=こどく
痛=いた
君=きみ
感=かん
一度=いちど
合=あ
愿=ねが
叶=かな
夜明=よあ
前=まえ
风=かぜ
頬=ほお
流=なが
香=かお
全=すべ
包=つつ
満=み
思=おも
出=で
羽=は
空=そら
舞=ま
上=あ
爱=あい
会=あ
声=こえ

梦=ゆめ
未=いま
忘=わす
物=もの
取=と
帰=かえ
古=ふる
思=おも
出=で
埃=ほこり
払=はら
戻=もど
幸=しあわ
最後=さいご
教=おし
言=い
隠=かく
昏=くら
过去=かこ
永远=えいえん
伤=きず
悲=かな
日=ひ
苦=くる
爱=あい
胸=むね
残=のこ
离=はな
苦=にが
匂=にお
雨=あめ
降=ふ
止=や
暗闇=くらやみ
背=せ
轮郭=りんかく
鲜明=せんめい
覚=おぼ
受=う
け止=と
出会=であ
涙=なみだ
何=なに
横颜=よこがお
同=おな
様=よう
淋=さび
中=なか
忘=わす
愿=ねが
自分=じぶん
思=おも
恋=こい
息=いき
侧=そば
确=たし
共=とも
胸=むね
苦=にが
降=ふ
切=き
分=わ
果実=かじつ
片方=かたほう

薄紅=うすべに
薄红=うすべに
彩=いろど
花=はな
笑=わら
光=ひかり
僕=ぼく
仆=ぼく
度=ど
腕=うで
泣=な
笑颜=えがお
守=まも
越=こ
近=ちか
鮮=あざ
鲜=あざ
砂=すな
城=しろ
透通=すきとお
波=なみ
世界=せかい
终=お
頼=たよ
色褪=いろあ
形=かたち
片隅=かたすみ
集=あつ
届=とど
真=ま
伸=の
送=おく
白=しろ
苍=あお
逺=とお
歌=うた

少=すこ
支=ささ
宝物=たからもの
