a=啊
ba=吧
be=布呃
bi=比
bo=博
bu=不
bya=不呀
byo=不呦
byu=不于
cha=查
che=彻
chi=吃
cho=抽
chu=除
da=大
de=的
dha=大哈
dho=的吼
dhu=的胡
di=滴
dji=鸡以
do=都
du=度
dwa=抓哇
dwe=主物
dwi=的为
dwo=的喔
dwu=的物
dzu=的组
e=额
fa=发
fe=负欸
fi=非
fo=佛
fu=福
ga=嘎
ge=鸽
gi=给一
go=苟
gu=谷
gwa=个瓦
gwe=个喔
gwi=个为
gwo=个喔
gwu=个物
gya=个呀
gyo=个呦
gyu=个于
ha=哈
he=何
hi=嘿一
ho=厚哦
hya=和呀
hyo=和哟
hyu=和于
i=以
ja=加
je=届
ji=鸡
jo=就
ju=巨
ka=咔
ke=克
ki=可一
ko=口
ku=库
kwa=可瓦
kwe=可喔
kwi=可为
kwo=可喔
kwu=可无
kya=可呀
kyo=可呦
kyu=可于
ma=嘛
me=每
mi=幂
mo=魔
mu=穆
mya=么呀
myo=么呦
myu=么于
n=嗯
na=呐
ne=内
ni=倪
no=喽
nu=奴
nya=呢呀
nyo=呢呦
nyu=呢于
o=哦
pa=怕
pe=普鹅
pi=批
po=破
pu=普
pya=普呀
pyo=普哟
pyu=普于
ra=啦
re=乐
ri=哩
ro=咯
ru=路
rya=了呀
ryo=了哟
ryu=了于
sa=撒
se=涩
sha=啥
she=舍
shi=西
sho=守
shu=树
so=搜
su=素
sya=西呀
syo=西油
syu=西于
ta=塔
te=得
ti=提
to=透
tsa=吃撒
tse=吃色
tsi=吃塞
tso=吃搜
tsu=触
tu=土
twa=特瓦
twe=特沃
twi=特未
two=特喔
twu=特物
u=唔
va=哇
ve=物欸
vi=物以
vo=物喔
vu=物唔
vya=物呀
vyo=物哟
vyu=物于
wa=瓦
we=为
wi=为欸
wo=沃
wo/o=沃
wu=物
ya=呀
yo=哟
yu=于
za=乍
ze=泽
zo=走
zu=组